32
32
WWWWWWWWWWWWWWWWWWWWWWWWWW
W...........WW...........W
W.WWWW.WWWW.WW.WWWW.WWWW.W
W.WWWW.WWWW.WW.WWWW.WWWW.W
W.WWWW.WWWW.WW.WWWW.WWWW.W
W........................W
W.WWWW.W.WWWWWWWW.W.WWWW.W
W.WWWW.W.WWWWWWWW.W.WWWW.W
W......W....WW....W......W
WWWWWW.WWWW-WW-WWWW.WWWWWW
WWWWWW.W----------W.WWWWWW
WWWWWW.W--WW--WW--W.WWWWWW
WWWWWW.W--W-GG-W--W.WWWWWW
------.---WG--GW---.------
WWWWWW.W
WWWWWW.W
WWWWWW.W
WWWWWW
W
W
W
W
W
W
W
W
W
W
W
W
WWWWWWWWWWWWWWWWWWWWWWWWWW